xxxxxxxxxxxxx
x e  tg     x
x p         x
x           x
xxxxxx   e  x
x           x
xe          x
x t      e  x
x           x
xxxxxxxxxxxxx
