xxxxxxxxxxxxx
x     x     x
x tp  x     x
x     x     x
x     x     x
x     x     x
x     x     x
x     x  t  x
x     x    gx
xxxxxxxxxxxxx
